111111111111
11P00E00C001
111111111111
