111111111111
11P000000001
111100000001
1111000M0001
111100000M01
1M1100111011
10M010101111
1M0110101111
10M010001111
1M1111101111
111100001111
101011001111
100000000111
101001111111
111000C11111
11M0100E1111
111111111111
111111111111
