1111111111
1C10EP0101
1111111111
