11111111111111111
1000E001111111111
100P0001111111111
10000101111111111
1011C001111111111
11111111111111111
