1111111111
1C00EP0101
1111111111
