111111111111111111111111111
11P000000000000000C00000001
11110000000011111000000C001
1111000M11M11M00M00M00M0001
111100110C000000000E0000M01
11110000000011111110000C001
1111000M11M11M00M00M00M0001
11110C00000000111100000C001
1111000M11M110C0M00MC0M0001
111111111111111111111111111
