111111111111
11P000000001
111100000001
1111000M0001
111100000M01
101100111011
100010101111
100110101111
100010001111
101111101111
111100001111
101011001111
100000000111
101001111111
111000001111
11M010CE1111
111111111111
111111111111
