11111111#
1000E001
100P0001
10000101
1011C011
11111111
