111111111111111111111111111
11P000000000000000C00000001
11110000M00011111000000C001
111100001101100000000000001
111100110C000000000E0000001
11110000000011111110000C001
111100001101100000M00000001
11110C0000M000111100000C001
11110000110110C00000C000001
111111111111111111111111111
