1111111111111111111111111111
10C00000000011000000000E1111
100000001100100000000C010011
10P0000C000000C0110000000111
101100000000C000000001000011
1111111111111111111111111111
