111111111111
11P000000001
111100000001
111100000001
111100000001
101100111011
100010101111
100110101111
100010001111
101111101111
111100001111
101011011111
100000000111
101011111111
111000001111
110010CE1111
111111111111
111111111111
