111111111111111111111111111
11P000000000000000C00000001
11110000M00011111000000C001
111100001001100000000000001
111100111C100000000E0000001
11110000010011111110000C101
111100001101100000M00000001
111111111111111111111111111
